#################################################################################################################################
#################################################################################################################################
#################################################################################################################################
#################################################################################################################################
#################################################################################################################################
#####*********************************************************#####*********************************************************#####
#####*********************************************************#####*********************************************************#####
#####*********************************************************#####*********************************************************#####
#####*********************************************************#####*********************************************************#####
#####*********************************************************#####*********************************************************#####
#####*********************************************************#####*********************************************************#####
#####*********************************************************#####*********************************************************#####
#####*********************************************************#####*********************************************************#####
#####*********************************************************#####*********************************************************#####
#####*********************************************************#####*********************************************************#####
#####*********************************************************#####*********************************************************#####
#####*********************************************************#####*********************************************************#####
#####*********************************************************#####*********************************************************#####
#####*********************************************************#####*********************************************************#####
#####*********************************************************#####*********************************************************#####
#####*********************************************************#####*********************************************************#####
#####*********************************************************#####*********************************************************#####
#####*********************************************************#####*********************************************************#####
#####*********************************************************#####*********************************************************#####
#####*********************************************************#####*********************************************************#####
#####*********************************************************#####*********************************************************#####
#####*******************#########################*************#####*************#########################*******************#####
#####*******************#########################*************#####*************#########################*******************#####
#####*******************#########################*************#####*************#########################*******************#####
#####*******************#########################*************#####*************#########################*******************#####
#####*******************#########################*************#####*************#########################*******************#####
#####*********************************************************#####*********************************************************#####
#####*********************************************************#####*********************************************************#####
#####***********************************************************************************************************************#####
#####***********************************************************************************************************************#####
#####***********************************************************************************************************************#####
#####***********************************************************************************************************************#####
#####***********************************************************************************************************************#####
#####***********************************************************************************************************************#####
#####***********************************************************************************************************************#####
#####***********************************************************************************************************************#####
#####***********************************************************************************************************************#####
#####***********************************************************************************************************************#####
#####***********************************************************************************************************************#####
#####*************************#####***********************************************************#####*************************#####
#####*************************#####***********************************************************#####*************************#####
#####*************************#####*****************#########################*****************#####*************************#####
#####*************************#####*****************#########################*****************#####*************************#####
#####*************************#####*****************#########################*****************#####*************************#####
#####*************************#####*****************#########################*****************#####*************************#####
#####*************************#####*****************#########################*****************#####*************************#####
#####*************************#####***********************************************************#####*************************#####
#####*************************#####***********************************************************#####*************************#####
#####*************************#####***********************************************************#####*************************#####
#####*************************#####***********************************************************#####*************************#####
#####*************************#####***********************************************************#####*************************#####
#####*************************#####***********************************************************#####*************************#####
#####*************************#####***********************************************************#####*************************#####
#####*************************#####***********************************************************#####*************************#####
#####*************************#####***********************************************************#####*************************#####
#####*************************#####***********************************************************#####*************************#####
#####*************************#####***********************************************************#####*************************#####
#################*************#####***********************************************************#####*************#################
#################*************#####***********************************************************#####*************#################
#################*************#####***********************************************************#####*************#################
#################*************#####***********************************************************#####*************#################
#################*************#####***********************************************************#####*************#################
#####*************************#####***********************************************************#####*************************#####
#####*************************#####***********************************************************#####*************************#####
#####*************************#####***********************************************************#####*************************#####
#####*************************#####***********************************************************#####*************************#####
#####*************************#####***********************************************************#####*************************#####
#####*************************#####***********************************************************#####*************************#####
#####*************************#####***********************************************************#####*************************#####
#####*************************#####***********************************************************#####*************************#####
#####*************************#####***********************************************************#####*************************#####
#####*************************#####***********************************************************#####*************************#####
#####*************************#####***********************************************************#####*************************#####
#####*************************#####*****************#########################*****************#####*************************#####
#####*************************#####*****************#########################*****************#####*************************#####
#####*************************#####*****************#########################*****************#####*************************#####
#####*************************#####*****************#########################*****************#####*************************#####
#####*************************#####*****************#########################*****************#####*************************#####
#####*************************#####***********************************************************#####*************************#####
#####*************************#####***********************************************************#####*************************#####
#####***********************************************************************************************************************#####
#####***********************************************************************************************************************#####
#####***********************************************************************************************************************#####
#####***********************************************************************************************************************#####
#####***********************************************************************************************************************#####
#####***********************************************************************************************************************#####
#####***********************************************************************************************************************#####
#####***********************************************************************************************************************#####
#####***********************************************************************************************************************#####
#####***********************************************************************************************************************#####
#####***********************************************************************************************************************#####
#####*********************************************************#####*********************************************************#####
#####*********************************************************#####*********************************************************#####
#####*******************#########################*************#####*************#########################*******************#####
#####*******************#########################*************#####*************#########################*******************#####
#####*******************#########################*************#####*************#########################*******************#####
#####*******************#########################*************#####*************#########################*******************#####
#####*******************#########################*************#####*************#########################*******************#####
#####*********************************************************#####*********************************************************#####
#####*********************************************************#####*********************************************************#####
#####*********************************************************#####*********************************************************#####
#####*********************************************************#####*********************************************************#####
#####*********************************************************#####*********************************************************#####
#####*********************************************************#####*********************************************************#####
#####*********************************************************#####*********************************************************#####
#####*********************************************************#####*********************************************************#####
#####*********************************************************#####*********************************************************#####
#####*********************************************************#####*********************************************************#####
#####*********************************************************#####*********************************************************#####
#####*********************************************************#####*********************************************************#####
#####*********************************************************#####*********************************************************#####
#####*********************************************************#####*********************************************************#####
#####*********************************************************#####*********************************************************#####
#####*********************************************************#####*********************************************************#####
#####*********************************************************#####*********************************************************#####
#####*********************************************************#####*********************************************************#####
#####*********************************************************#####*********************************************************#####
#####*********************************************************#####*********************************************************#####
#####*********************************************************#####*********************************************************#####
#################################################################################################################################
#################################################################################################################################
#################################################################################################################################
#################################################################################################################################
#################################################################################################################################