              #########                     #########                     #########              
              #########                     #########                     #########              
              #########                     #########                     #########              
              #########                     #########                     #########              
              #########                     #########                     #########              
              #########                     #########                     #########              
              #########                     #########                     #########              
              #########                     #########                     #########              
              #########                     #########                     #########              
              #########                     #########                     #########              
              #########                     #########                     #########              
                                                                                                 
                                                                                                 
                                                                                                 
                                                                                                 
                                                                                                 
        *                   *         *                   *         *                   *        
                                                                                                 
                                                                                                 
                                                                                                 
                                                                                                 
                                                                                                 
                                                                                                 
                                                                                                 
                  *                   *                   *                   *                  
                                                                                                 
                                                                                                 
                                                                                                 
                                                                                                 
                                                                                                 
    #########           #########           #########           #########           #########    
    #########           #########           #########           #########           #########    
    #########           #########           #########           #########           #########    
    #########           #########           #########           #########           #########    
    #########           #########           #########           #########           #########    
    #########           #########           #########           #########           #########    
    #########           #########           #########           #########           #########    
    #########           #########           #########           #########           #########    
    #########           #########           #########           #########           #########    
    #########           #########           #########           #########           #########    
    #########           #########           #########           #########           #########    
    #########           #########           #########           #########           #########    
    #########           #########           #########           #########           #########    
    #########           #########           #########           #########           #########    
    #########           #########           #########           #########           #########    
    #########           #########           #########           #########           #########    
    #########           #########           #########           #########           #########    
    #########           #########           #########           #########           #########    
    #########           #########           #########           #########           #########    
    #########           #########           #########           #########           #########    
    #########           #########           #########           #########           #########    
    #########           #########           #########           #########           #########    
    #########           #########           #########           #########           #########    
    #########           #########           #########           #########           #########    
    #########           #########           #########           #########           #########    
    #########           #########           #########           #########           #########    
    #########           #########           #########           #########           #########    
    #########           #########           #########           #########           #########    
    #########           #########           #########           #########           #########    
    #########           #########           #########           #########           #########    
    #########           #########           #########           #########           #########    
    #########           #########           #########           #########           #########    
    #########           #########           #########           #########           #########    
    #########           #########           #########           #########           #########    
    #########           #########           #########           #########           #########    
    #########           #########           #########           #########           #########    
    #########           #########           #########           #########           #########    
                                                                                                 
                                                                                                 
                                                                                                 
                                                                                                 
                                                                                                 
                  *                   *                   *                   *                  
                                                                                                 
                                                                                                 
                                                                                                 
                                                                                                 
                                                                                                 
                                                                                                 
                                                                                                 
                                                                                                 
                                                                                                 
                                                                                                 
                                                                                                 
                                                                                                 
                                                                                                 
                                                                                                 
                                                                                                 
                                                                                                 
                                                                                                 
                        #########                               #########                        
                        #########                               #########                        
                        #########                               #########                        
                        #########                               #########                        
                        #########                               #########                        
                        #########                               #########                        
                        #########                               #########                        