              #########                     #########                     #########              
              #########                     #########                     #########              
              #########                     #########                     #########              
              #########                     #########                     #########              
              #########                     #########                     #########              
              #########                     #########                     #########              
              #########                     #########                     #########              
              #########                     #########                     #########              
              #########                     #########                     #########              
              #########                     #########                     #########              
              #########                     #########                     #########              
                                                                                                 
                                                                                                 
                                                                                                 
          *               *             *               *             *               *          
                                                                                                 
                                                                                                 
                                                                                                 
                                                                                                 
                                                                                                 
                                                                                                 
                                                                                                 
                                                                                                 
                                                                                                 
                                                                                                 
                                                                                                 
                *   *               *   *               *   *               *   *                
                                                                                                 
                                                                                                 
                                                                                                 
    #########           #########           #########           #########           #########    
    #########           #########           #########           #########           #########    
    #########           #########           #########           #########           #########    
    #########           #########           #########           #########           #########    
    #########           #########           #########           #########           #########    
    #########           #########           #########           #########           #########    
    #########           #########           #########           #########           #########    
    #########           #########           #########           #########           #########    
    #########           #########           #########           #########           #########    
    #########           #########           #########           #########           #########    
    #########           #########           #########           #########           #########    
    #########           #########           #########           #########           #########    
    #########           #########           #########           #########           #########    
    #########           #########           #########           #########           #########    
    #########           #########           #########           #########           #########    
    #########           #########           #########           #########           #########    
    #########           #########           #########           #########           #########    
    #########           #########           #########           #########           #########    
    #########           #########           #########           #########           #########    
    #########           #########           #########           #########           #########    
    #########           #########           #########           #########           #########    
    #########           #########           #########           #########           #########    
    #########           #########           #########           #########           #########    
    #########           #########           #########           #########           #########    
    #########           #########           #########           #########           #########    
    #########           #########           #########           #########           #########    
    #########           #########           #########           #########           #########    
    #########           #########           #########           #########           #########    
    #########           #########           #########           #########           #########    
    #########           #########           #########           #########           #########    
    #########           #########           #########           #########           #########    
    #########           #########           #########           #########           #########    
    #########           #########           #########           #########           #########    
    #########           #########           #########           #########           #########    
    #########           #########           #########           #########           #########    
    #########           #########           #########           #########           #########    
    #########           #########           #########           #########           #########    
                                                                                                 
                                                                                                 
                                                                                                 
                *   *               *   *               *   *               *   *                
                                                                                                 
                                                                                                 
                                                                                                 
                                                                                                 
                                                                                                 
                                                                                                 
                                                                                                 
                                                                                                 
                                                                                                 
                                                                                                 
                                                                                                 
                                                                                                 
                                                                                                 
                                                                                                 
                                                                                                 
          *               *             *               *             *               *          
                                                                                                 
                                                                                                 
                                                                                                 
              #########                     #########                     #########              
              #########                     #########                     #########              
              #########                     #########                     #########              
              #########                     #########                     #########              
              #########                     #########                     #########              
              #########                     #########                     #########              
              #########                     #########                     #########              